   WE                            textures/wolfenstein/grey_stone.png
NO      textures/wolfenstein/purple_stone.png



SO textures/wolfenstein/red_brick.png

F      139, 69, 19

EA textures/wolfenstein/wood.png



C 108, 187, 255

111111111111111111111111
100000000000000000000001
100000000000000000000001
100000000000000000000001
100000111110000101010001
100000100010000000000001
100000100010000100010001
100000100010000200000001
100000110110000101210001
100000000000000000000001
100000000000000000000001
100000000000000000000001
100000000000000000100001
100000000000000000010001
100000000000000000000001
100000000000000000000001
111111111000000000000001
110100001000000000000001
110000101000000000000001
110100001000000000000001
110111111000000000000001
110000000000N00000000001
111111111000000000000001
111111111111111111111111
