   WE                            textures/wolfenstein/eagle.png 
NO      textures/wolfenstein/grey_stone.png



SO textures/wolfenstein/red_brick.png

F   69, 222, 199

EA textures/wolfenstein/mossy.png



C 235, 198, 52

111111111
10000H001
1E0000001
10000C001
111111111
