







NO textures/test/north.xpm








SO textures/test/south.xpm
                        WE textures/test/west.xpm
        EA textures/test/east.xpm            

        F 20,           20,             20
C 200,          200,200
                                                                                   
1111111111111111111111111111111111111111111111111111111111111111
1S00000000000000000000000000000000000000000000000000000000000001
1111111111111111111111111111111111111111111111111111111111111101
                                                             101
                                                             101
                                                             101
                                                             101
                                                             101
                                      111111111111           101
                                      100000000001           101
11111111111111111111111111111111111111100000000001           101
10000000000000000000000000000000000000000000000001           101
10111111111111111111111111111111111111100000000001           101
101                                   100000000001           101
101                                   111111111111           101
101                                                          101
101                                                          101
101                                                          101
101                                                          101
101                                                          101
101                                                          101
101                                                          101
101                                                          101
101                                                          101
101                                                          101
101                                                          101
101                                                          101
101                                                          101
101                                                          101
101                                                          101
1011111111111111111111111111111111111111111111111111111111111101
1000000000000000000000000000000000000000000000000000000000000001
1111111111111111111111111111111111111111111111111111111111111111                                                                                                                                       
